+++++-+++++
++++   ++++
+++     +++
++       ++
|    1    |
++       ++
+++     +++
++++   ++++
+++++-+++++
